../Assets/Image_Assets/Tiles/TileMap.png
0,1 0,1 0,1 0,1 0,1 0,4 0,4 0,4 0,4 0,4 0,4 0,4 0,3 0,3 0,3 0,3 0,3 0,3 0,3 0,3
0,1 0,1 0,1 0,1 0,1 0,4 0,4 0,4 0,4 0,4 0,4 0,3 0,3 0,3 0,3 0,3 0,3 0,3 0,3 0,3
0,1 0,1 0,1 0,1 0,1 0,4 0,4 0,4 0,4 0,4 0,4 0,4 0,3 0,3 0,3 0,3 0,3 0,3 0,3 0,3
0,1 0,1 0,1 0,1 0,4 0,4 0,4 0,4 0,4 0,4 0,4 0,4 0,4 0,3 0,3 0,3 0,3 0,3 0,3 0,3
0,1 0,1 0,1 0,4 0,4 0,4 0,4 0,4 0,4 0,4 0,4 0,4 0,3 0,3 0,3 0,3 0,3 0,3 0,3 0,3
0,4 0,4 0,4 0,4 0,4 0,4 0,4 0,4 0,4 0,4 0,4 0,3 0,3 0,3 0,3 0,3 0,3 0,3 0,3 0,3
0,4 0,4 0,4 0,4 0,4 0,4 0,4 0,4 0,4 0,4 0,4 0,4 0,3 0,3 0,3 0,3 0,3 0,3 0,3 0,3
0,4 0,4 0,4 0,4 0,4 0,4 0,4 0,4 0,4 0,4 0,4 0,4 0,4 0,3 0,3 0,3 0,3 0,3 0,3 0,3
0,4 0,4 0,4 0,4 0,4 0,4 0,4 0,4 0,4 0,4 0,4 0,4 0,3 0,3 0,3 0,3 0,3 0,3 0,3 0,3
0,4 0,4 0,4 0,4 0,4 0,4 0,4 0,4 0,4 0,4 0,4 0,3 0,3 0,3 0,3 0,3 0,3 0,3 0,3 0,3
0,4 0,4 0,4 0,4 0,4 0,4 0,4 0,4 0,4 0,4 0,4 0,4 0,3 0,3 0,3 0,3 0,3 0,3 0,3 0,3
0,3 0,4 0,4 0,4 0,3 0,4 0,4 0,4 0,3 0,4 0,3 0,3 0,3 0,3 0,3 0,3 0,3 0,3 0,3 0,3
0,3 0,3 0,4 0,3 0,3 0,3 0,4 0,3 0,3 0,3 0,3 0,3 0,3 0,3 0,3 0,3 0,3 0,3 0,3 0,3
0,3 0,3 0,3 0,3 0,3 0,3 0,3 0,3 0,3 0,3 0,3 0,3 0,3 0,3 0,3 0,3 0,3 0,3 0,3 0,3
0,3 0,3 0,3 0,3 0,3 0,3 0,3 0,3 0,3 0,3 0,3 0,3 0,3 0,3 0,3 0,3 0,3 0,3 0,3 0,3
0,3 0,3 1,3 5,3 5,3 5,3 5,3 5,3 5,3 2,3 0,3 0,3 0,3 0,3 0,3 0,3 0,3 0,3 0,3 0,3
0,3 0,3 8,3 0,5 0,5 0,5 0,5 0,5 0,5 6,3 0,3 0,3 0,3 0,3 0,3 0,3 0,3 0,3 0,3 0,3
0,3 0,3 8,3 0,5 0,5 0,5 0,5 0,5 0,5 6,3 0,3 0,3 0,3 0,3 0,3 0,3 0,3 0,3 0,3 0,3
0,3 0,3 8,3 0,5 0,5 0,5 0,5 0,5 0,5 6,3 0,3 0,3 0,3 0,3 0,3 0,3 0,3 0,3 0,3 0,3
0,3 0,3 8,3 0,5 0,5 0,5 9,3 7,3 7,3 4,3 0,3 0,3 0,3 0,3 0,3 0,3 0,3 0,3 0,3 0,3